###########################
###...................#####
#####....................###
######........@.........###
###..................####
##.........##.........######
##.........##............##
###########################